geoid,name,B07013001,"B07013001, Error",B07013002,"B07013002, Error",B07013003,"B07013003, Error",B07013004,"B07013004, Error",B07013005,"B07013005, Error",B07013006,"B07013006, Error",B07013007,"B07013007, Error",B07013008,"B07013008, Error",B07013009,"B07013009, Error",B07013010,"B07013010, Error",B07013011,"B07013011, Error",B07013012,"B07013012, Error",B07013013,"B07013013, Error",B07013014,"B07013014, Error",B07013015,"B07013015, Error",B07013016,"B07013016, Error",B07013017,"B07013017, Error",B07013018,"B07013018, Error"
05000US06059,"Orange County, CA",3093077,1762,1762384,15101,1330693,14716,2727617,7296,1637891,14307,1089726,14467,234363,6571,78924,3791,155439,5037,76360,3809,26778,2144,49582,3366,32205,2388,10626,1315,21579,1925,22532,2008,8165,1025,14367,1656
16000US0600947,"Aliso Viejo, CA",50543,226,29534,1483,21009,1457,44366,1005,27675,1432,16691,1599,4620,794,1499,433,3121,691,638,332,204,116,434,289,658,319,108,83,550,305,261,159,48,31,213,161
16000US0602000,"Anaheim, CA",336904,563,158416,4655,178488,4551,301961,2865,148162,4199,153799,5159,22688,2331,5843,984,16845,2198,8648,1529,3113,930,5535,1286,1888,423,563,208,1325,386,1719,440,735,187,984,376
16000US0608100,"Brea, CA",46210,273,29122,1447,17088,1473,40201,947,27095,1503,13106,1415,3533,755,1145,395,2388,679,1601,470,671,294,930,333,335,136,108,63,227,134,540,341,103,64,437,339
16000US0608786,"Buena Park, CA",81379,367,46438,2654,34941,2543,73519,1104,43369,2635,30150,2557,4464,878,1635,481,2829,661,2559,517,979,368,1580,493,539,240,233,165,306,178,298,158,222,148,76,50
16000US0616532,"Costa Mesa, CA",108131,271,44693,2007,63438,2020,92068,1366,40865,1900,51203,2178,11817,1250,3118,832,8699,999,2420,581,481,206,1939,529,873,246,114,75,759,235,953,462,115,72,838,445
16000US0616580,"Coto de Caza, CA",15465,1236,14126,1286,1339,458,13772,1144,12793,1184,979,400,1012,325,758,284,254,150,267,126,234,116,33,39,414,283,341,278,73,77,0,21,0,21,0,21
16000US0617750,"Cypress, CA",49433,118,33701,1313,15732,1312,46066,719,32001,1176,14065,1260,1520,450,461,159,1059,404,1330,688,928,670,402,199,323,170,196,143,127,97,194,132,115,91,79,91
16000US0617946,"Dana Point, CA",32518,143,20317,1333,12201,1300,27204,931,18149,1415,9055,1235,3692,883,1242,513,2450,776,978,511,631,434,347,209,579,270,230,121,349,234,65,56,65,56,0,28
16000US0625380,"Fountain Valley, CA",55774,165,37239,1551,18535,1538,50077,1104,35339,1612,14738,1722,4438,968,1391,470,3047,829,684,236,300,131,384,188,428,177,131,78,297,163,147,82,78,55,69,57
16000US0628000,"Fullerton, CA",137077,369,70959,2675,66118,2595,120353,1627,66886,2553,53467,2684,10378,1339,2277,422,8101,1234,4258,694,1179,262,3079,638,940,350,243,95,697,338,1148,426,374,239,774,339
16000US0629000,"Garden Grove, CA",167320,351,92429,2891,74891,2884,156086,1283,87718,2854,68368,2950,8076,1030,3385,639,4691,893,1785,422,877,303,908,262,529,177,167,72,362,159,844,296,282,111,562,281
16000US0636000,"Huntington Beach, CA",194112,437,110353,2635,83759,2578,168275,1854,102626,2627,65649,2727,15451,1413,4850,641,10601,1276,5278,934,1514,327,3764,858,3813,783,959,285,2854,681,1295,534,404,225,891,474
16000US0636770,"Irvine, CA",290980,692,134364,5067,156616,5034,228807,3924,120887,4926,107920,4654,33363,3126,7316,1467,26047,2685,13882,1968,2277,491,11605,1883,7570,1424,1447,601,6123,1265,7358,1342,2437,778,4921,1018
16000US0639114,"Ladera Ranch, CA",23926,1181,18194,1327,5732,1146,20312,1435,16382,1295,3930,974,2361,757,813,481,1548,665,813,441,701,412,112,126,258,190,158,139,100,145,182,126,140,103,42,68
16000US0639178,"Laguna Beach, CA",22706,83,16481,689,6225,687,19741,605,14986,800,4755,619,1708,490,634,194,1074,416,725,384,468,325,257,152,409,171,312,155,97,81,123,78,81,62,42,51
16000US0639220,"Laguna Hills, CA",30399,133,21913,1096,8486,1109,27579,589,20680,1093,6899,1061,1828,511,871,340,957,297,558,174,190,80,368,182,142,87,111,78,31,36,292,150,61,41,231,145
16000US0639248,"Laguna Niguel, CA",63505,155,42115,1538,21390,1528,55977,904,39534,1525,16443,1588,4753,881,1649,420,3104,782,1447,406,515,234,932,349,1030,348,248,198,782,282,298,144,169,97,129,127
16000US0639259,"Laguna Woods, CA",17380,48,12143,519,5237,514,15671,329,11048,549,4623,553,991,250,612,235,379,152,454,166,264,102,190,140,235,125,190,102,45,73,29,36,29,36,0,21
16000US0639290,"La Habra, CA",61571,210,34374,1478,27197,1485,55300,869,32261,1476,23039,1378,2603,624,959,313,1644,556,3126,639,1032,291,2094,538,162,108,50,59,112,88,380,240,72,103,308,241
16000US0639496,"Lake Forest, CA",83960,255,59444,2330,24516,2320,74071,1129,53839,2217,20232,2204,7230,1147,4191,920,3039,781,1626,540,1028,405,598,377,640,268,307,174,333,171,393,272,79,67,314,274
16000US0640256,"La Palma, CA",15459,62,10805,680,4654,697,13900,437,9819,729,4081,678,424,208,253,185,171,108,955,394,575,346,380,209,74,77,52,72,22,26,106,170,106,170,0,21
16000US0640526,"Las Flores, CA",5696,938,4228,654,1468,785,4800,674,3983,646,817,455,756,537,245,205,511,484,45,74,0,19,45,74,7,13,0,19,7,13,88,146,0,19,88,146
16000US0643224,"Los Alamitos, CA",11407,66,4830,528,6577,529,10176,316,4532,508,5644,550,443,195,156,102,287,152,703,245,118,89,585,232,0,21,0,21,0,21,85,78,24,30,61,71
16000US0647430,"Midway City, CA",7881,1358,2459,584,5422,1267,7303,1344,2265,519,5038,1276,514,303,194,214,320,180,23,38,0,19,23,38,12,20,0,19,12,20,29,47,0,19,29,47
16000US0648256,"Mission Viejo, CA",90045,422,70079,1990,19966,1780,81675,1152,65638,2006,16037,1908,6064,1106,3252,725,2812,707,1021,270,593,176,428,223,852,251,326,130,526,221,433,216,270,205,163,128
16000US0648410,"Modjeska, CA",718,281,642,278,76,63,514,117,438,117,76,63,200,201,200,201,0,13,0,13,0,13,0,13,4,6,4,6,0,13,0,13,0,13,0,13
16000US0651182,"Newport Beach, CA",84131,198,48570,1943,35561,1919,69585,1805,44553,1894,25032,2064,8909,1359,2715,733,6194,1164,2554,629,694,307,1860,656,2164,717,460,215,1704,641,919,308,148,83,771,294
16000US0652379,"North Tustin, CA",24634,1725,21060,1621,3574,995,22518,1672,19292,1548,3226,919,1683,519,1521,522,162,119,161,94,140,89,21,25,207,188,42,41,165,189,65,90,65,90,0,25
16000US0653980,"Orange, CA",130633,329,76198,2536,54435,2555,117478,1455,71178,2457,46300,2600,9258,1281,3434,588,5824,1158,2246,599,789,235,1457,526,1172,347,469,227,703,249,479,273,328,234,151,136
16000US0657526,"Placentia, CA",50731,163,32294,1533,18437,1514,45728,1050,29851,1470,15877,1572,3760,957,1822,663,1938,698,839,340,337,132,502,320,197,157,171,152,26,41,207,139,113,92,94,86
16000US0659503,"Rancho Mission Viejo, CA",10516,1139,8380,990,2136,551,8328,1095,6942,1008,1386,419,1465,472,954,363,511,277,275,221,80,103,195,195,439,316,395,313,44,56,9,17,9,17,0,21
16000US0659587,"Rancho Santa Margarita, CA",47246,159,35402,1178,11844,1199,41854,1169,32451,1193,9403,1017,4296,1065,2517,640,1779,839,406,144,253,134,153,99,530,449,116,82,414,439,160,103,65,53,95,91
16000US0663050,"Rossmoor, CA",11704,1180,10005,1242,1699,454,10687,1099,9360,1127,1327,469,375,166,289,148,86,83,438,244,313,220,125,102,50,32,43,30,7,12,154,160,0,21,154,160
16000US0665084,"San Clemente, CA",63390,188,43026,1729,20364,1726,55547,1105,39829,1700,15718,1643,4512,888,1656,513,2856,731,1594,437,605,271,989,405,1448,656,806,583,642,282,289,154,130,103,159,128
16000US0668028,"San Juan Capistrano, CA",34536,216,23848,1409,10688,1426,30599,840,22070,1343,8529,1304,3070,858,1057,420,2013,776,535,350,482,319,53,63,202,129,182,116,20,34,130,119,57,83,73,83
16000US0669000,"Santa Ana, CA",303910,492,138935,4074,164975,4110,278007,2208,132233,3851,145774,4512,18759,1900,5033,850,13726,1730,5246,1211,1055,288,4191,1205,1012,310,301,154,711,271,886,264,313,137,573,230
16000US0670686,"Seal Beach, CA",24685,70,18826,600,5859,598,22182,625,17433,865,4749,553,1054,316,535,240,519,206,1042,565,674,563,368,144,344,172,144,129,200,108,63,52,40,47,23,23
16000US0671918,"Silverado, CA",856,198,725,199,131,81,768,192,662,193,106,73,79,73,60,66,19,29,3,6,3,6,0,13,6,8,0,13,6,8,0,13,0,13,0,13
16000US0673962,"Stanton, CA",37717,168,17867,1526,19850,1546,35100,766,16571,1361,18529,1528,2004,691,953,527,1051,439,414,172,256,131,158,117,92,60,66,42,26,42,107,123,21,33,86,120
16000US0680210,"Trabuco Canyon, CA",1137,487,1100,488,37,36,1108,487,1071,488,37,36,29,25,29,25,0,13,0,13,0,13,0,13,0,13,0,13,0,13,0,13,0,13,0,13
16000US0680854,"Tustin, CA",77229,374,38128,2172,39101,2156,66483,1919,35432,2006,31051,2092,7803,1847,1815,789,5988,1674,1653,493,469,225,1184,437,722,296,274,153,448,269,568,316,138,91,430,303
16000US0682744,"Villa Park, CA",5727,28,5185,337,542,340,5020,354,4768,373,252,150,457,331,272,224,185,256,243,172,138,111,105,135,0,19,0,19,0,19,7,11,7,11,0,19
16000US0684550,"Westminster, CA",89538,214,48451,2111,41087,2080,81992,866,45952,2139,36040,2022,5615,738,1828,472,3787,666,975,319,262,119,713,310,461,211,206,155,255,177,495,318,203,248,292,230
16000US0685587,"Williams Canyon, CA",36,69,36,69,0,13,36,69,36,69,0,13,0,13,0,13,0,13,0,13,0,13,0,13,0,13,0,13,0,13,0,13,0,13,0,13
16000US0686832,"Yorba Linda, CA",67083,198,56033,1467,11050,1474,59768,1237,51388,1473,8380,1445,4824,1093,2764,736,2060,800,1514,610,1173,564,341,175,390,194,318,181,72,53,587,268,390,179,197,201
